140
50
   X X X X  X   X  X X X X   X  X    X  X X X X  X   X         X X   X    X X X X  X X     X  X        X  X   X X     X          X      X X
 X            X            X       X               X   X  X X      X   X                X       X X X       X     X X   X X X X     X X
   X  XXX X X   X X  X       X X         X    XXX    X        X           X X  X  X  X    X X          X X    X                 X       X X
      X X     X         X         X X X     X X X X       X      XXX X                 X      X  X X X           X X X    X        X X
X     X X        X X X    X     X       X     X X   X   X    X X X X   X  X X   X  X     X X           X  X  X X       X    X X        X X X
  X X XXX  X X X       X     X    X  X    X   XXX     X          X X X        X       X      X  X X X             X X    X       X X
                 XXX       X           X    X      X     X  X X  XXX    X X X       X   X X           X X X     X     X    X X X     X X
X  X    X X  X X X X X X X   X X X X      X    X X                    X          X    X     XXX X  X         X    XXX    X                X
      X          X X                  X X    X     X  X    X  X  X  X   X  X X X    X    X  X X      X X        X X X X       X X  X X X
 X          XXX  XXX  X  X    X     X          X X      X             X          X     X    X X X X      X X  X   X X     X X              X
    X X  X  X X             X   X X      X X         X    X X XXX  X    X X X X     X    X  XXX                 X XXX  X          X    X X
  X         X X      X        X     X X       X  X X          X X                X     X       XXX  X  X  X  X            XXX X X    X     X
X           XXX X  X   X X      X X     X               X X X X X X  X  X          X       X X X X               X X    X X X
  X X X  X           X     X  X           X X X    X  X       XXX          X X X X   XXX X     X X  X X  X     X      X   X X X X  X  X X X
X          X  X  X X    X          X X  X       X         X        X X  X          X X X     X XXX          X    X  X     XXX
       X X            X    X X X X         X  X     X  X    X    X          X    X   X X X        XXX  X X     X      X X     X X       X  X
 X X X      X X  X X    X          X X   X        X      X    X    X X X X     X   X XXX    X X   X X        X    X                X X
          X          X     X X X X     X     X X     X X         X         X                    X X X X  XXX    X    X  X X  X X X     X X X
  X     X   X X X X    X X         X      X      X         X X          X     X X X X    X X      XXX    X X X     X                X
X   XXX             X      X X X     X      X X     X    X     X X X X                 X     X X       X X X          X X X X   X     X  X X
  X X X  X  X X  X                X    X  X     X      X   X           X X XXX  X X X     X        X X   XXX X X  X           X    X
    X X            X  XXX      X     X       X     X     X    X  X  X      X X        X X   X X  X                  X    X  X        X  X
X X XXX  X X  X X     X X X X            X X   X X   X X    X         X  X X X  X X                X  X  X X  X X      X       X X X      X
                      X X     X  X X X X     X     X           XXX X       XXX      X X  X X  X  X                X  X    X
  X X XXX      X X  X XXX X X            X X            X X  X X X   X         X X                   X       XXX            X  X   XXX X X X
X     X X X  X                 X  X          X  X    X         X X      X X X         X     X XXX X     X X  X X X X XXX  X      X X X
   X  X X      X  X X     X          XXX  X        X        X  XXX  X          X X X     X    X X    X       X X     X X           X X X X
      XXX  X           X     X   X   X X    X   X    X X  X           XXX  X X       X X    X X X X          XXX  X  X X  X X  X X XXX     X
X X X        X X X   X    X    X   X X X X    X             X  X   X  X X       X        X    XXX   X   XXX          XXX               X X
       X           X   X         X   XXX        X  X X  X X      X    X X    X    X XXX           X   X X X    X  X       X X  X X X X     X
         X X  X  X   X   X   X           X X  X             X  X    X XXX  X        X X   X  X X    X   X X X       X X X              X X
 X  X                           X  X  X         X X X X  X        X          X X    X X X         X   X XXX                    X X X       X
       X   X X X X   X  X  X  X         X X   X               X      X X X       X  XXX      X X    X          X X X    X XXX         X
 X  X    X         X               X X      X   X  X X  X X X    X X        X X          X X     X        X X        X    X X     X X    X X
      X      X         X         X     X  X   X               X       X X X     X X    X           X X  X     X    X      X X X X
 X X     X X   X X X X   X X X X   X X          X  X X X X X                 X      X         X  X               X   X  X XXX         X X  X
     X X               X         X          X                X  X X  X X X X     X        X X         X X  X X                   X  X
X        X    X X  X       X X X     X X X    X      X X X                   X X   X X X      X  X  X           X   X X X     X        X  X
   X X X   X          X X        XXX       X    X X        X X X  X X X    X                             X        X        X     X  X
 X       X    X X         X    X X X  X X     X     X X                  X   X X  X X X X  X X X  X X X    X X X     X        X       X X
   X X X    X      X X       X   X X      X X     X     X X   X X X X X    X                            X        X      X X X   X X X     X
X         X     X      X   X     XXX X X      X X           X                   X X X    X    X X X X X   X         X         X       X
  X X X     X X   X      X   X X          X X       X X X X   X X X    X X  X          X    X               X  X      X X X     X  X    X
X       X           X X          X  X  X      X  X          X       X         X  X   X    X   X      X X         X  X                X     X
   X X     X X  XXX     X X  X X         X                    X        X  XXX      X    X       X  X      X    X      X  X   X           X
       X X      X X X X          X X X X   X X X X X X  X X X   X X X     X X  X X          X               X    XXX       X    X  XXX X   X
 X         X    X X       X X X                               X         X X X       X  X X    X     X  X  X    X X X X X           X X   X
   X X  X    X  XXX   X X       X  X    X X X X X X X X   X X   X X X X   XXX   X X         X    X               X X     X  X X  X X X X   X
X         X         X        X        X                 X               X     X     X X X X        X  X    X  X  XXX   X           XXX
  X X X X   X X X X    X X X   X X X    X X X X X X  X    X  X  X X  X     X    X X         X X X       X            X   X   X X X      X X